################################################################################################################################
#                                                                                                                              #
#                                                                                                                              #
#                                                                                                                              #
#                                                                                                                              #
#                                                                                                                              #
#                                                                                                                              #
#                                                                                                                              #
#                                                                                                                              #
#                                                                                                                              #
#                                                                                                                              #
#                                                                                                                              #
#                                                                                                                              #
#                                                                                                                              #
#                                          #########                                                                           #
#                                          #########                                                                           #
#                                          #       #                                                                           #
#                                          #       #                                                                           #
#                                                                                                                              #
#                                                                                                                              #
#                                                                                                                              #
#                                                                                                                              #
#                                                                                                                              #
#                                                                                                                              #
#                                                                                                                              #
#                                                                                                                              #
#                                                                                                                              #
#                                                                                                                              #
#                                                                                                                              #
#                                                                                                                              #
#                                                                                                                              #
#                                                                                                                              #
#                                                                                                                              #
#                                                                                                                              #
#                                                                                                                              #
#                                                                                                                              #
#                                                                                                                              #
#                                                                                                                              #
#                                                                                                                              #
################################################################################################################################

