#################################################
#                                               #
#                                               #
#                  ######### ##                 #
#                  #    #     #                 #
#                  ############                 #
#                                               #
#                                               #
#                                               #
#################################################
