################################################################################################################################
#                                                                                                                              #
#                                                                                                                              #
#                                                                                                                              #
#                                                                                                                              #
#                                                                                                                              #
#                                                                                                                              #
#                                                                                                                              #
#                                                                                                                              #
#      #################################                                                                                       #
#      #                               #                                                                                       #
#      #                               #                                                                                       #
#      #                               #                                                                                       #
#      #                               #                                                                                       #
#      #                               #                                                                                       #
#      #########################       #   #########                                                                           #
#                              #       #   #       #                                                                           #
#                              #       #   #       #####                                                                       #
#                              #       #   #           #                                                                       #
#                              #       #   ########### #                                                                       #
#                              #       #             # #                                                                       #
#                              #       #             # #                                                                       #
#                              #       #             #D#                                                                       #
#                              #       #             # #                                                                       #
#                              #       #             # #                                                                       #
#                              #       ############### #                                                                       #
#                              #                       #                                                                       #
#                              #########################                                                                       #
#                                                                                                                              #
#                                                                                                                              #
#                                                                                                                              #
#                                                                                                                              #
#                                                                                                                              #
#                                                                                                                              #
#                                                                                                                              #
#                                                                                                                              #
#                                                                                                                              #
#                                                                                                                              #
#                                                                                                                              #
################################################################################################################################
