###############################################################################
#                                                                             # 
#                                                                             # 
#                                                                             # 
#          ##### #####                                                        # 
#          #         #                                                        # 
#          #         #                                                        # 
#          #         #                                                        # 
#          #     >   #                                                        # 
#          ###########                                                        # 
#                                                                             # 
#                                                                             # 
#                                                                             # 
#                                                                             # 
#                                                                             # 
#                                                                             # 
#                                                                             # 
#                                                                             # 
#                                                                             # 
#                                                                             # 
#                                                                             # 
#                                                                             # 
#                                                                             # 
#                                                                             # 
#                                                                             # 
#                                                                             # 
#                                                                             # 
#                                                                             # 
#                                                                             # 
#                                                                             # 
#                                                                             # 
#                                                                             # 
#                                                                             # 
#                                                                             # 
#                                                                             # 
#                                                                             # 
#                                                                             # 
#                                                                             # 
#                                                                             # 
###############################################################################
