###############################################################################
#                                                                             # 
#                                                                             # 
#                                                                             # 
#                                                                             # 
#                                                                             # 
#                                                                             # 
#                                                                             # 
#                                                                             # 
#                                                                             # 
#                                                                             # 
#                                                                             #
#                                                                             # 
#                                                                             # 
#                                                                             # 
#                                                                             # 
#                                                                             # 
#                                                                             # 
#                                                                             # 
#         #############################  ######                               # 
#         #     <                             #                               # 
#         #####################################                               # 
#                                                                             # 
#                                                                             # 
#                                                                             # 
#                                                                             # 
#                                                                             # 
#                                                                             # 
#                                                                             # 
#                                                                             # 
#                                                                             # 
#                                                                             # 
#                                                                             # 
#                                                                             # 
#                                                                             # 
#                                                                             # 
#                                                                             # 
#                                                                             # 
###############################################################################
